T W W W W W W W W W W W W T
W 0 G R 0 G G G M G R R 0 W
W 0 D 0 B B B B B B B B B W
W G 0 0 0 C 0 G 0 R G G E W
W B B B B B B B B B B 0 0 W
W R G 0 0 G G R C G 0 R G W
W G 0 B B B B B B B B B M W
W R E 0 G 0 C 0 0 0 G G R W
W B B B B B B B B B B R 0 W
W C R 0 G G R E 0 G G G 0 W
W 0 G B B B B B B B B B B W
W G 0 0 G 0 G G 0 0 0 P M W
W B B B B C B B B B B B B W
T W W W W W W W W W W W W T
