T W W W W W W W W W W W W T
W 0 G 0 0 G G R 0 G 0 0 0 W
W 0 D 0 G R 0 G G 0 C G B W
W G 0 0 0 G 0 G 0 R R G 0 W
W 0 G 0 G 0 G G 0 G G B 0 W
W R G 0 0 B B B 0 0 0 G G W
W G 0 G 0 B C B G G 0 0 R W
W B 0 0 G B B B 0 0 G G 0 W
W G 0 R G 0 G G 0 0 R G B W
W 0 G 0 G G R 0 0 G G G 0 W
W G G 0 0 0 G 0 G G 0 0 G W
W 0 0 C G 0 B G 0 0 0 P 0 W
W 0 R 0 G B 0 0 G 0 0 G 0 W
T W W W W W W W W W W W W T
