T W W W W W W W W W W W W T
W 0 G 0 0 G G R 0 G 0 0 0 W
W 0 D R G R 0 G R 0 R G G W
W G G 0 B G R G 0 G R G 0 W
W 0 G 0 G 0 G R C G G B 0 W
W R G 0 0 B E B 0 0 R G G W
W C R G R B C R G G 0 E R W
W G 0 R G B B B R 0 G G C W
W G 0 R G 0 G G R 0 B G B W
W R G 0 G G R B 0 G G G 0 W
W G G 0 0 0 G 0 G G 0 0 G W
W 0 0 R G C G G B 0 0 P 0 W
W G R 0 G R 0 0 G 0 0 G 0 W
T W W W W W W W W W W W W T
